************************
** * *** * **** * ** ***
****   *** *** *** * ***
           $            
**** ******* **  *** ***
         $              
* ** ** ***** **** ** **
               $       
*** ***** * ****** * ***
                        
****  ***** **   * *****
                 $      
* *** ** ** * **** ** **
                        
*** *** *@** ** ***** **
  $                     
* ** ** *** *** ** * ***
                    $  
** **** *** ** **** * **
         $              
** * *** ** **** **  ***
      $                 
* *** ** *** ** * *** **
************************