******* **** **** ********
* @               $      * 
*                        *
****************    ******        
*                        *
*       $                *
**********     ******    *
*                        *
*      $  ********       *
*                        *
*  ******************* $ *
*       $                *
*                        *
**   ******    ******   **
**  ***            ***  **
**  ***  $      $  ***  **  
**  ***            ***  **
**  ******************  **
*                    $   *
* **  **************  ** * 
*     $                  *  
*      **************    *
*           $            *
*********   *******   ****        
*     $             $    *
******* **** **** ********