************************
** * *** * **** * ** ***
**** $ *** *** *** * ***
                        
**** ******* ** $*** ***
                        
* **$** ***** **** ** **
                        
*** ***** * ****** * ***
                        
**** $***** ** $ * *****
                        
* *** ** ** * **** ** **
                        
*** *** *@** ** ***** **
                        
* ** ** *** *** ** * ***
                        
** **** ***$** **** * **
                        
** *$*** ** **** ** $***
                        
* *** ** *** ** * *** **
************************