******* **** **** ********
* @               $      * 
*                        *
****************    ******        
*       $                *
*                        *
**********     ******    *
*                        *
*   $     ********   $   *
*                        *
*  *******************   *
*                        *
*                        *
**   ******    ******   **
**$ ***            ***  **
**  ***  $      $  ***  **  
**  ***            ***  **
**  ******************  **
*               $        *
* **  **************  ** * 
*                        *  
*  $   **************    *
*                        *
*********   *******   ****        
*                  $     *
******* **** **** ********